1111111111111111111111111111111111111111
10P0000010000000000000000000000100000001
1001100010000000110001111000000100000001
1000000000000001010D00001000000000000001
1111100010001000010001111001000100011111
1000000010001000010000001001000100000001
1001100010001000111001111001000100011001
1000000010001000000000000001000100000001
1111111110001000000000000001000111111111
1000000000001000000000000001000000000001
1000011111111001111001111001111111100001
1000000000000001000D00001000000000000001
1000011111111001111111111001111111100001
1000000000001000000000000001000000000001
1111111110001000000000000001000111111111
1000000010001000000000000001000100000001
1001100010001001111001111101000100011001
1000000010001000001000001001000100000CC1
11111CCC1CCC1CC1111CCCC1CCC1CCC1CCC11111
1CCCCCCCCCCCCCCCCC1CCCC1CCCCCCCCCCCCCCC1
1CC11CCC1CCCCCC1111CCCC1CCCCCCC1CCCCCCC1
1CCCCCCC1CCCCCCCCCCCCCCCCCCCCCC1CCCCCCE1
1111111111111111111111111111111111111111