1111111111111111111111111111111111111111
1cpccccc1cccccccccccccccccccccc1ccccccc1
1cc11ccc1ccccccc11ccc1111cccccc1ccccccc1
1cccccccccccccc1c1cDcccc1cccccccccccccc1
11111ccc1ccc1cccc1ccc1111cc1ccc1ccc11111
1ccccccc1ccc1cccc1cccccc1cc1ccc1ccccccc1
1cc11ccc1ccc1ccc111cc1111cc1ccc1ccc11cc1
1ccccccc1ccc1cccccccccccccc1ccc1ccccccc1
111111111ccc1cccccccccccccc1ccc111111111
1ccccccccccc1cccccccccccccc1ccccccccccc1
1cccc11111111cc1111cc1111cc11111111cccc1
1cccccccccccccc1ccccD0001cccccccccccccc1
1cccc11111111cc1111111111cc11111111cccc1
1ccccccccccc1cccccccccccccc1ccccccccccc1
111111111ccc1cccccccccccccc1ccc111111111
1ccccccc1ccc1cccccccccccccc1ccc1ccccccc1
1cc11ccc1ccc1cc1111cc11111c1ccc1ccc11cc1
1ccccccc1ccc1ccccc1ccccc1cc1ccc1ccccccc1
11111ccc1ccc1cc1111cccc1ccc1ccc1ccc11111
1ccccccccccccccccc1cccc1ccccccccccccccc1
1cc11ccc1cccccc1111cccc1ccccccc1ccccccc1
1ccccccc1cccccccccccccccccccccc1ccccccE1
1111111111111111111111111111111111111111