1111111111111111111111111111111111111111
10p000001000000000000000c000000100000001
1001100010000000110001111000000100000001
100000000000000101000D001000000000000001
1111100010001000010001111001000100011111
1000000010001000010000001001000100000001
1001100010001000111001111001000100011001
1000000010001000000000000001000100000001
1111111110001000000000000001000111111111
1000000000001000000000000001000000000001
1000011111111001111001111001111111100001
10000000000000010000D0001000000000000001
1000011111111001111111111001111111100001
1000000000001000000000000001000000000001
1111111110001000000000000001000111111111
1000000010001000000000000001000100000001
1001100010001001111001111101000100011001
1000000010001000001000001001000100000001
1111100010001001111000010001000100011111
1000000000000000001000010000000000000001
1001100010000001111000010000000100000001
10000000100000000000000000000001000000E1
1111111111111111111111111111111111111111