1111111111111111111111111111111111111111
10p0000010000000000000000000000100000001
1001100010000000110001111000000100000001
1000000000000001010D00001000000000000001
1111100010001000010001111001000100011111
1000000010001000010000001001000100000001
1001100010001000111001111001000100011001
1000000010001000000000000001000100000001
1111111110001000000000000001000111111111
1000000000001000000000000001000000000001
1000011111111001111001111001111111100001
10000000000000010000D0001000000000000001
1000011111111001111111111001111111100001
1000000000001000000000000001000000000001
1111111110001000000000000001000111111111
1000000010001000000000000001000100000001
1001100010001001111001111101000100011001
1000000010001000001000001001000100000cc1
11111ccc1ccc1cc1111cccc1ccc1ccc1ccc11111
1ccccccccccccccccc1cccc1ccccccccccccccc1
1cc11ccc1cccccc1111cccc1ccccccc1ccccccc1
1ccccccc1cccccccccccccccccccccc1ccccccE1
1111111111111111111111111111111111111111